NO pics/purple_stone.xpm
SO                        pics/grey_stone.xpm
EA pics/wall4v.xpm
WE pics/color_stone.xpm


C 69, 49, 224
F  148, 118, 99
                                                        11111111111111111111111111111111111111111111111
                                                       100000000000000000000000000000000000000000000011
      11111111111111111111111111111111111111111111111111000000000000000000000000000000000000000000000011
 11111101000000000000000000000000000000000000000000000000000000000000001000000000000000000000000000000011
 100000000000000000000000000000001111111111111111111111100000000000000000000000000000000000000000000000011
 11000000000000000011110000000000001   110000000001    1000000000000000000000000000000000000000000000000011
 1111111111111111111  11111110111111   111111111001    10000000000000000000000000100000000000000000000000011
                           10001               1001    100000000000000000000000111100000000000000000000000011
 11111111111111111     111110001111111111111   100111  1000000000000000000000001111100000000000000000000000011
 11000000000000011    1100000000000000000001   100001  10000000000000000000000111 11100000000000000000000000011
 10000000000000001    1000000000000000000001   1100011 1000000000000000000000111   11100000000000000000000000011
 11000000000000011    1100000000000111110001   1000001 10000000000W00000000000111 11100000000000000000000000011
 1000000000000001      1000000000001   10001   1000001 1000000000000000000000001111100000000000000000000000011
 11100000000000011111111000000000001   10001   10000011100000000000000000000000011100000000000000000000000011
  1111000000000000001000000000000001   10001  11000000000000000000000000000000000100000000000000000000000011
  1111000000000000001000000000000001   10001  10000000000000000000000000000000000100000000000000000000000011
  1100000000000000000000000001111111   11111  1000111111000000000000000000000000000000000000000000000000011
  11111000001100000000000000000001            10001    100000000000001000000000000000000000000000000000011
111000000000000000000000000001111111111111111110001    1000000000000010000000000110000000000000000000001
111111000000000000000000000000000000000000000000001    1000000000000010000000001000000000000000000000011
    11111100000000000000000011111111111111111000001    100000000000001000000000000000000000000000000011
        1111110000000000111111            111111111    10000000000000000000000000000000000000000000011
            11111111001111111111                       1000000000000000000000000000000000000000000011
                  110011                        11111110000000000111111111111110001111111111111111111
11111111111111111111011111111111111111111111111110000000000000000100000000000000000000000000000001
10000000100000000000000100000000000000000000000010000000000000000100000000000000000000000000000001
10001000000001000000100000000000000000000000000010000000000000000100000000000000000000000000000001
111111111111111111110011111111111111111111111111100000011111101111111111111111111111100111111111111
                  110011                     111100000011   101                      101              
                  110011                     100000000011   101                      101               
                  110011                     100111100011   101                      101              
                  110011                     1001  100011   101                      101              
             1111111001111111111111111111111110011110001111110111111111111111111     101                                      
             100000000000000000000000000000000000000000000000000000000000111111111111101                                
             100000000000000000000111111111111111110000000000000000000000000000000000001                                
             1111100000000000000001     111      100000000000000000000001111111111111101                               
                 100000000000000001              11000000111111111111111111          101                                
    11111111111111000000000000001111111111111111110000011                            101              
    110000000000000000000000000000000000000000000000000011       11111111111111111   101                                       
    110000000000000000000000000000000000000000000000000011       10000000000000001   111                                       
    11000000010001111111100011111111001111110000000000011111111110000000001000001    111                                       
    11000000110000000000100000000001000000010000000000000000000000000000010000001    111                                       
    11000001010000000000100000000001000000010000000000000000000000000000100000001    101                                       
    11000000010001111111100011111111000000010000000000011111111110000001001000001    101                                       
    11000000010000000000100000000001000000010000000000011       111111111111111111111111
    11000000010000000000100000000001000000010000000000011       100001000000000000010001
    11000000010000000000100000000001000000010000000000011   1111101110000100000000010001
    11000000010001111111100011111111000000010000000000011   100000100000000000000001001
    110000000000000000000000000000000000000000000000000011   100000000000000010000011111
    110000000000000000000000000000000000000000000000000011   100000000000000000000010101
    11111111111111111111111111111111111111111111111111111    11111111111111111111111111111