

NO pics/eagle.xpm
SO pics/blue_stone.xpm
EA pics/red_brick.xpm
WE pics/mossy.xpm



C 25,25,99
F 228, 212,225

1111111111111111111111111111111111111
1000000000000000000000000000000000001
1000000000000000000000000000000000001
1000000000000000000000000000000000001
1000000000000000000000000000000000001
1000000000000000000000000000000000001
1000000000000000000000000000000000001
1000000000000000000000000000000000001
1000000000000000000000000000000000001
1000000000000000000000000000000000001
1000000000000000000000000000000000001
10000000000000W0000000000000000000001
1000000000000000000000000000000000001
1111111111111111111111111111111111111
