

NO pics/eagle.xpm
SO pics/blue_stone.xpm
EA pics/red_brick.xpm
WE pics/mossy.xpm



C 0,0,0
F 0,0,0

1111111111111111111111111111111111111
1000000 000000000000000000000000000001
10000000000000W0000011111111110000001
1000000000000000000000000000000000001
1111111111111111111111111111111111111
